%%%%%%%%%%%%%%%%%%%%%%%%%%%%%%%%
%                             .%
%  %%%%%%%%%%% %%%%%%%%%%%%%%% %
%% %                         % %
%  % %%%%%%%%%%%%%%%%%%%%% % % %
%% % %          %%%%%%   % % % %
%  % % %%%%%%%%        % % % % %
%% % %        %%%%%%%% % % % % %
%  % % %%%%%%       .% % % % % %
%% % %       %%%%%%%%% % % % % %
%  %   %%%%%           %.% % % %
%% % %%%%%%%%%%%%%%%%%%%%% % % %
%  %                         % %
% %%%%%%%%%%%% %%%%%%%%%%%%%%% %
%.    P                        %
%%%%%%%%%%%%%%%%%%%%%%%%%%%%%%%%
