%%%%%%%%%%%%%%%%%%%%%%%%%%%%%%%%
%                             .%
%  %%%%%%%%%%% %%%%%%%%%%%%%%% %
%% %P                        % %
%  % %%%%%%%%%%%%%%%%%%%%% % % %
%% % %.         %%%%%%   % % % %
%  % % %%%%%%%%        % % % % %
%% % %        %%%%%%%% % % % % %
%  % % %%%%%%       .% % % % % %
%% % %       %%%%%%%%% % % % % %
%  %   %%%%%           %.% % % %
%% % %%%%%%%%%%%%%%%%%%%%% % % %
%  %                         % %
% %%%%%%%%%%%% %%%%%%%%%%%%%%% %
%.                          P  %
%%%%%%%%%%%%%%%%%%%%%%%%%%%%%%%%